00000000000000000000000000000000
00000000000000000000000000000000
000000000000F000000000000000000E
0000000F000000BF0000000BBF0FFFFB
00000B000FF000000F000F000SSSSSSS
0000SBSSSSSSSSSSSS0000000BBBBBBB
000BBBBBBBBBBBBBBBBB000000000000
0000BBssssssssssssss000000000000
BB0000000000000000000S0000F0F000
000BBBBBBBBBBBBBBBBBBBB0000000F0
000000000000000000000000F0000000
0000000000000000000000000000000z
0000000000000000000000000000000V
000000000000000000000000S000000V
00000000000000BBBB0jHHHiBiHHHj0V
0000BB0000000000000000000000000x
D000000000BBB0000000000000000000
BBBSSSSBBSSSSSSSSSSSSSSSSSSSSSSS