00000000000000000000000000000000
D0000000000000000000000000000000
BBBBB000000000000000000000000000
0000000000000000000000000000000E
000000FFF000000000000000S000BFFB
000BF0SSS000000000000F0BBBB00000
000000BBB00000000000P000000FF000
BBBB00000000000000F0F00000000VV0
0000S00000000000F000000000000VV0
0000B000000000000000000000000VV0
00000000000000000F00F00000000VV0
00S00000SSSSSSSSSSB000F000000ii0
00BBFB00BBBBBBBBBB000000BBB00000
0000000000ssssssss00000000000000
000000000000000000000000BBBBBBBF
iHHHHHHj00jHHHHHHi000FF000000000
00000SSSSSSSSSSSS0FF000000000000
SSSSSBBBBBBBBBBBBSSSSSSSSSSSSSSS