00000000000000000000000000000000
D0000000000000000000000000000000
BBBBB000000000000000000000000000
0000000000000000000000000000000E
000000FFF0000000000000000000BBBB
000BB0SSS000000000000F0BBBB00000
000000BBB000000000S0P000000FF000
BBBB00000000000000B0F00000000VV0
0000S00000000000F000000000000VV0
0000B0000000000000S0000000000VV0
00000000000000000FB0F00000000VV0
000S0S00SSSSSSSSSS0000F000000ii0
00BBFB00BBBBBBBBBB000000BBB00000
0000000000ssssssss00000000000000
000000000000000000000000BBBBBBBF
iHHHHj00jHHHHHHHHi000FF000000000
00000SSSSSSSSSSSS0FF000000000000
SSSSSBBBBBBBBBBBBSSSSSSSSSSSSSSS