00000000000000000000000000000000
00000000000000000000000000000000
00000000000000000000000000000000
BBBB0000000000000000000000000000
BBBB0000000000000000000000000000
BBBB0000000000000000000000000000
BBBB0000000000000000000000000000
BBBB0000000000000000000000000000
BBBB0000000000000000000000000000
BBBB0000000000000000000000000000
BBBB00000000000BBB00000000000000
BBBB0000000000000000000000000000
BBBB00000000BBB00000000000000000
BBBB0000000000000000000000000000
BBBB0000000000BBB000000000000000
BBBB0000000BB000F000000000000000
BBBB0000000BB000F000000000000000
BBBBBBBBBBBBBBBBBBBBBBBBBBBBBBBB