00000000000000000000000000000000
00000000000000000000000000000000
D0000000000000000000000000000000
BBBB0000000000000000000000000000
BBBB0000000000000000000000000000
BBBB0000000000000000000000000000
BBBB0000000000000000000000000000
BBBB0000000000000000000000000000
BBBB0000000000000000000000000000
BBBB0000000000BBB000000000000000
BBBB0000000000000000000000000000
BBBB000000BBB0000000000000000000
BBBB0000000000000000000000000000
BBBB0000000000BBB000000000000000
BBBB0000000G0000F000000000000000
BBBB0000000BB000F000000000000000
BBBB0000000BB000FSSSSS0000000000
BBBBBBBBBBBBBBBBBBBBBBBBBBBBBBBB