00000000000000000000000000000000
00000000000000000000000000000000
00000000000000000000000000000000
0000000000000000000000000000000E
00000000000000000000000BBB0FBBBB
000000000000000000000B000SSSSSSS
0000BBBBBBBBBBBBBBBB00000BBBBBBB
000BBBssssssssssssss000000000000
BB0000000000000000000S0000F0F000
000BBBBBBBBBBBBBBBBBBBB0F00000F0
0000000000000000000000000000000z
0000000000000000000000000000000V
0000000000000000000000000000000V
0000000000000000000000000000000V
00000000000000BBB0jHHHHHHHHHHi0V
0000BB0000BBB000000000000000000x
D0000000000000000000000000000000
BBBSSSSBBSSSSSSSSSSSSSSSSSSSSSSS